_a_a_wo_mie_gao_nie_ne_shao	啊啊我灭高捏呢少
_ba_ba_bo_die_kao_lie_le_rao	巴巴伯爹靠列了绕
_pa_pa_po_tie_hao_jie_ge_hao	怕怕破铁好借个号
_ma_ma_mo_nie_zhao_qie_biao_ben	妈妈墨涅找且标本
_fa_fa_fo_lie_chao_xie_piao_nen	发发佛烈抄写票嫩
_da_da_duo_jie_shao_yue_miao_kong	大大多杰少岳庙空
_ta_ta_tuo_qie_rao_nue_diao_hong	他他托切绕虐刁洪
_na_na_nuo_xie_zao_lue_tiao_jiong	娜娜诺写早略条囧
_la_la_luo_yue_cao_jue_you_qiong	拉拉落月草觉又穷
_ga_ga_guo_nue_sao_que_miu_xiong	嘎嘎过虐扫却缪红
_ka_ka_kuo_lue_yao_xue_diu_zhong	卡卡阔略要学丢中
_ha_ha_huo_jue_niao_ei_pu_ao	哈哈火觉鸟欸普奥
_zha_zha_zhuo_que_liao_bei_mu_bao	渣渣卓缺料贝母奥
_cha_cha_chuo_xue_jiao_pei_fu_pao	查查辍学教培副炮
_sha_sha_shuo_ei_miao_kun_qu_ao	莎莎说欸秒昆曲奥
_za_za_ruo_bei_diao_hun_xu_bao	咋咋若被掉混续保
_ca_ca_zuo_pei_tiao_zhun_er_ao	擦擦作陪调准而奥
_sa_sa_cuo_mei_you_chun_zi_ao	飒飒错没有春子奥
_ya_ya_suo_fei_miu_shun_ci_bao	丫丫索菲缪顺次包
_dia_dia_e_xue_qiao_run_si_pao	嗲嗲鹅学桥润丝跑
_lia_lia_me_ei_diu_zun_zhi_ao	俩俩么欸丢遵旨奥
_jia_jia_de_bei_niu_cun_chi_bao	佳佳德贝牛尊吃饱
_qia_qia_te_pei_liu_sun_shi_pao	恰恰特配六损失跑
_xia_xia_ne_mei_jiu_fang_ta_zou	下下呢没旧房砸头
_wa_wa_le_fei_qiu_wang_na_cou	娃娃了非球王那凑
_gua_gua_ge_dei_xiu_guang_la_sou	瓜瓜个得修光啦搜
_kua_kua_ke_tei_ran_wu_zhuo_ao	夸夸可忒然乌卓奥
_hua_hua_he_nei_duan_bu_chuo_bao	花花河内端部戳爆
_zhua_zhua_zhe_lei_tuan_pu_shuo_pao	抓抓这类湍瀑说跑
_chua_chua_che_gei_nuan_mu_ruo_mao	欻欻车给暖木箬帽
_shua_shua_she_kei_luan_fu_zuo_dao	耍耍蛇剋卵负坐到
_wo_wo_e_hei_ruan_dui_le_zhao	我我额黑软对了找
_bo_bo_me_zhei_zuan_tu_cuo_tao	伯伯么这钻涂错套
_po_po_de_shei_cuan_nu_suo_nao	婆婆的谁窜奴所闹
_mo_mo_te_zei_suan_lu_e_chao	默默地贼算路恶炒
_fo_fo_ne_wei_wen_gu_me_ao	佛佛讷维稳固么奥
_duo_duo_le_dui_dun_ku_de_bao	多多了对顿库德堡
_tuo_tuo_ge_tui_tun_hu_te_pao	妥妥个腿屯胡特跑
_nuo_nuo_ke_gui_lun_zhu_ne_mao	诺诺可贵论著呢毛
_luo_luo_he_kui_gun_chu_le_dao	洛洛和亏滚出了到
_guo_guo_zhe_hui_kun_shu_ge_tao	果果这回坤叔个套
_kuo_kuo_che_zhui_hun_ru_ke_nao	扩阔车追魂如可恼
_huo_huo_she_chui_zhun_zu_he_lao	或火舌吹准组合老
_zhuo_zhuo_re_shui_chun_cu_zhe_gao	灼灼热水春促这高
_chuo_chuo_ze_rui_shun_su_che_kao	戳戳泽瑞顺素车靠
_shuo_shuo_ce_zui_run_yu_ca_ao	说说测最润宇擦奥
_ruo_ruo_se_cui_zun_nv_sa_bao	若若瑟崔尊女撒包
_zuo_zuo_ye_tui_cun_lv_ya_pao	做作业推存绿芽跑
_cuo_cuo_bie_gui_sun_jv_dia_mao	搓搓别亏损据嗲毛
_suo_suo_pie_kui_fang_biao_kuang_gang	索索撇葵芳裱框杠
_e_e_ye_hui_wang_piao_huang_kang	饿饿夜会王票黄康
_me_me_bie_zhui_guang_miao_zhuang_hang	么么别追光苗庄行
_de_de_pie_chui_kuang_diao_chuang_zhang	的的撇吹狂掉窗长
_te_te_mie_shui_huang_tiao_shuang_chang	特特灭水黄条双长
_ne_ne_die_rui_zhuang_you_yong_shang	讷讷爹瑞装有用上
_le_le_tie_zui_chuang_miu_dong_zang	乐乐铁嘴床缪东葬
_ge_ge_nie_cui_shuang_diu_tong_cang	哥哥捏崔双丢筒仓
_ke_ke_lie_sui_yong_niu_nong_sang	可可列随用牛农桑
_he_he_jie_ao_mei_he_huo_lao	和何洁奥美合伙老
_zhe_zhe_qie_bao_fei_zhe_zhuo_gao	这这切薄飞着卓高
_che_che_xie_pao_dei_che_chuo_kao	车车斜抛得车戳靠
_she_she_yue_mao_tei_she_shuo_hao	射射月貌忒设说好
_re_re_nue_dao_nei_re_ruo_zhao	热热虐到内热若找
_ze_ze_lue_tao_lei_ze_zuo_chao	啧啧略套雷泽座超
_ce_ce_jue_nao_gei_ce_cuo_shao	测测绝闹给测错少
_se_se_que_lao_kei_se_suo_rao	色色却老剋瑟缩绕
_ye_ye_ei_fou_hei_ye_niu_chong	爷爷欸否黑夜牛冲
_bie_bie_bei_dou_zhei_bie_liu_rong	别别被都这别刘荣
_pie_pie_pei_tou_shei_pie_jiu_zong	撇撇呸投谁撇九总
_mie_mie_mei_nen_zei_mie_qiu_cong	咩咩没嫩贼灭求从
_die_die_fei_lou_wei_die_xiu_song	爹爹飞楼微跌秀松
_tie_tie_dei_gou_dui_tie_ran_ao	贴贴得狗对贴然奥
_nie_nie_tei_kou_tui_nie_duan_bao	捏捏忒口推捏断包
_lie_lie_nei_hou_gui_lie_tuan_pao	列列内后归猎团跑
_jie_jie_lei_zhou_kui_jie_nuan_mao	姐姐雷州葵姐暖毛
_qie_qie_gei_chou_hui_qie_luan_dao	切切给抽回且乱刀
_xie_xie_kei_shou_zhui_xie_ruan_tao	谢谢剋受追写软陶
_yue_yue_hei_rou_chui_yue_zuan_nao	月月黑肉垂月钻闹
_nue_nue_zhei_zou_shui_nue_cuan_lao	虐虐这邹水虐窜老
_lue_lue_shei_cou_rui_lue_suan_gao	略略谁凑瑞略酸高
_jue_jue_zei_sou_zui_jue_wen_kao	决绝贼搜最绝文考
_que_que_wei_biao_cui_que_dun_hao	雀雀为表翠雀顿号
_xue_xue_dui_piao_sui_xue_tun_zhao	学学对票随学屯找
_ei_ei_du_she_diao_che_tuo_zao	诶诶毒蛇吊车托早
_bei_bei_tu_re_tiao_she_nuo_cao	贝贝徒惹条蛇诺操
_pei_pei_nu_ze_you_re_luo_sao	陪陪怒责有热络扫
_mei_mei_lu_ce_miu_ze_guo_yao	妹妹路测牛泽国要
_fei_fei_gu_se_diu_ce_kuo_niao	菲菲古色丢测阔鸟
_dei_dei_ku_ye_ke_zhua_luan_chao	嘚嘚枯叶可抓卵巢
_tei_tei_hu_bie_he_chua_ruan_shao	忒忒胡别和欻软烧
_nei_nei_zhu_pie_zhe_shua_zuan_rao	内内猪撇折刷钻绕
_lei_lei_chu_mie_che_wo_gua_lao	蕾蕾除灭车我挂老
_gei_gei_shu_die_she_bo_kua_gao	给给叔爹射波跨高
_kei_kei_ru_tie_re_po_hua_kao	剋剋如铁热破化靠
_hei_hei_zu_nie_ze_mo_zhua_hao	黑黑组聂则莫抓好
_zhei_zhei_cu_lie_ce_fo_chua_zhao	这这粗劣测佛欻找
_shei_shei_su_jie_se_duo_shua_chao	谁谁苏戒色多刷超
_zei_zei_yu_lia_tiao_e_ran_zao	贼贼与俩条愕然早
_wei_wei_nv_jia_you_me_duan_cao	微微女家有么段操
_dui_dui_lv_qia_miu_de_tuan_sao	对对绿恰缪的团扫
_tui_tui_ju_xia_diu_te_nuan_yao	推推巨侠丢特暖腰
_gui_gui_qu_wa_niu_ne_luan_niao	鬼鬼去挖牛呢鸾鸟
_kui_kui_xu_gua_liu_le_ruan_liao	葵葵序卦留了软料
_hui_hui_er_shi_chua_cuan_pa_dao	灰灰而是欻窜爬到
_zhui_zhui_zi_sha_jiu_ge_zuan_jiao	追追紫砂九个钻聊
_chui_chui_ci_za_qiu_ke_cuan_qiao	吹吹此砸球客窜桥
_shui_shui_si_ca_xiu_he_suan_xiao	谁谁诉擦修核算小
_rui_rui_zhi_gua_ran_zhe_wen_lou	蕊蕊直挂染着问楼
_zui_zui_chi_kua_duan_ri_shua_tao	最最吃跨段日刷套
_cui_cui_shi_hua_tuan_a_suan_dou	翠翠石化团啊酸豆
_sui_sui_ri_zhua_nuan_ba_wen_tou	岁岁日抓暖把文投
_ao_ang_ye_yi_lue_qi_yue_xiao	奥昂业已掠起月销
_bao_bang_bie_bi_jue_xi_nue_mou	堡邦别逼觉戏虐某
_pao_pang_pie_pi_que_wu_nue_fou	跑旁撇皮却无虐否
_mao_mang_mie_mi_xue_bu_lue_dou	毛忙咩米雪不略都
_dao_dang_die_di_ei_ya_yong_ao	到当叠底欸呀永奥
_tao_tang_tie_ti_bei_dia_dong_bao	讨糖铁蹄被嗲东宝
_nao_nang_nie_ni_pei_lia_tong_pao	闹囊捏你配俩同跑
_lao_lang_lie_li_mei_jia_nong_mao	老狼列里每家农贸
_gao_gang_ga_sun_dui_qia_long_dao	高岗噶孙对掐龙岛
_kao_kang_ka_fang_qie_pu_gong_tao	靠康卡方且普工套
_hao_hang_ha_wang_xie_mu_jue_tou	好航哈王谢幕绝投
_zhao_zhang_zha_guang_yue_fu_que_nen	找张轧光岳父却嫩
_chao_chang_cha_kuang_nue_du_xue_lou	超长插框虐督学楼
_shao_shang_sha_huang_lue_tu_ei_ou	烧伤沙皇略图欸偶
_rao_rang_jie_ji_fei_xia_kong_nao	扰攘阶级废虾空闹
_zao_zang_za_zhuang_jue_nu_bei_ben	早藏咋装绝怒被本
_cao_cang_ca_chuang_que_lu_pei_pou	草仓擦窗却陆配剖
_sao_sang_sa_shuang_xue_gu_mei_mou	扫桑萨霜雪顾梅某
_yao_yang_tuo_la_dun_tui_wa_nao	要养拖拉蹲腿哇闹
_niao_niang_nuo_ga_tun_gui_gua_qiao	鸟娘诺尬屯贵挂桥
_liao_liang_luo_ka_lun_kui_kua_xiao	嘹亮罗卡伦奎跨校
_jiao_jiang_guo_ha_gun_hui_hua_chou	椒江过哈滚绘画抽
_qiao_qiang_kuo_zha_kun_zhui_zhua_shou	敲墙阔扎昆追抓手
_xiao_xiang_huo_cha_hun_chui_chua_rou	小巷或察浑吹欻肉
_ou_en_eng_zhuo_sha_xiong_re_rou	欧恩鞥卓杀兄热肉
_ben_beng_chuo_za_zhun_shui_shua_cun	本崩戳咋准水刷村
_pou_pen_peng_shuo_ca_zhong_ze_pou	剖喷鹏说擦重则剖
_mou_men_meng_ruo_sa_chong_ce_mou	某门梦若撒重测某
_fou_fen_feng_zuo_ya_rong_se_fou	否分封做雅容色否
_dou_deng_cuo_dia_chun_rui_wo_miu	都等错嗲纯瑞我谬
_tou_teng_suo_lia_shun_zui_bo_diu	头疼所俩顺嘴波丢
_nen_neng_e_wa_run_cui_po_niu	嫩能额哇润催迫牛
_lou_leng_me_gua_zun_sui_mo_liu	楼冷么挂尊岁末牛
_gou_gen_geng_de_yi_dei_fo_shou	狗跟更得意得佛手
_kou_ken_keng_te_bi_tei_duo_rou	口肯坑特比忒多肉
_hou_hen_heng_ne_pi_nei_tuo_zou	后很横呢皮内拖走
_zhou_zhen_zheng_le_mi_lei_nuo_cou	周真正勒米雷诺凑
_chou_chen_cheng_ge_di_gei_luo_sou	抽陈诚各地给罗搜
_shou_shen_sheng_ke_ti_kei_guo_biao	受神圣课题剋国标
_rou_ren_reng_he_ni_hei_kuo_piao	柔韧仍和你黑阔票
_zou_zen_zeng_zhe_li_zhei_huo_miao	走怎增这里这火苗
_cou_cen_ceng_che_ji_shei_zhuo_diao	凑岑蹭车及谁卓掉
_sou_sen_seng_she_qi_zei_chuo_tiao	搜森僧舍弃贼戳条
_biao_biao_ran_zong_ma_zong_duo_chou	表表冉总马总多愁
_piao_piao_duan_cong_fa_shi_po_hou	飘飘段从法师泼猴
_miao_miao_tuan_song_da_ri_mo_zhou	喵喵团送达日莫州
_diao_diao_nuan_yi_ju_cha_tu_tao	调调暖一句插图套
_tiao_tiao_luan_bi_qu_sha_nu_nao	跳跳乱必去杀怒闹
_you_you_ruan_pi_xu_za_lu_lao	又有软皮需杂录老
_miu_miu_zuan_mi_er_chi_si_mao	缪缪钻密耳赤思茅
_diu_diu_cuan_di_zi_ha_gu_gao	丢丢窜弟子哈孤高
_niu_niu_suan_ti_ci_zha_ku_kao	妞妞算题刺扎库靠
_liu_liu_wen_ni_si_cha_hu_hao	六六温妮斯茶壶好
_jiu_jiu_dun_li_zhi_lia_zhu_zhao	九九吨离职俩烛照
_qiu_qiu_tun_ji_chi_jia_chu_chao	球球囤积持家初潮
_xiu_xiu_lun_qi_shi_qia_shu_shao	秀秀论起时恰树梢
_ran_ran_gun_xi_ri_xia_ru_rao	然然滚昔日下入绕
_duan_duan_fang_shu_shua_zu_ti_kao	短短防暑刷组替考
_tuan_tuan_wang_ru_wo_dei_shuo_dou	团团王如我得说都
_nuan_nuan_guang_zu_bo_tei_ruo_tou	暖暖光祖波忒若头
_luan_luan_kuang_cu_po_nei_zuo_nen	乱乱狂粗破内做嫩
_ruan_ruan_huang_su_mo_lei_cuo_lou	软软黄素莫雷错漏
_zuan_zuan_zhuang_yu_fa_cu_ni_hao	钻钻状语发粗你好
_cuan_cuan_chuang_nv_da_su_li_zhao	窜窜床女大苏黎昭
_suan_suan_shuang_lv_ta_yu_kua_rao	算算双率他与夸绕
_wen_wen_yong_ju_na_nv_hua_zao	问问用具那女花藻
_dun_dun_dong_qu_la_lv_zhua_cao	顿顿东区拉吕抓操
_tun_tun_tong_xu_ga_ju_chua_sao	吞吞铜须噶句欻扫
_lun_lun_nong_er_zhi_wa_qu_pao	轮轮浓而织袜去泡
_gun_gun_long_zi_ta_xu_shua_yao	滚滚笼子他徐刷要
_kun_kun_gong_ci_na_er_ri_mao	坤坤宫词那尔日毛
_hun_hun_kong_si_la_zi_sa_niao	混混空司拉兹萨鸟
_zhun_zhun_hong_zhi_cha_ci_ya_liao	准准红只差雌鸭寮
_chun_chun_jiong_chi_sha_si_dia_jiao	春春囧吃沙司嗲交
_shun_shun_qiong_shi_za_zhi_wo_gou	顺顺穷士杂志我够
_run_run_xiong_ri_ca_chi_bo_kou	润润凶日擦赤膊口
_zun_zun_zhong_a_tie_wo_cui_qiao	尊尊中阿贴我翠巧
_cun_cun_chong_ba_nie_bo_sui_xiao	村村冲吧聂伯虽小
_sun_sun_rong_pa_lie_po_you_long	孙孙荣帕列波游龙
_fang_fang_yi_hu_fo_gei_suo_fou	芳芳一胡佛给所否
_wang_wang_bi_zhu_duo_kei_e_yao	往往比猪多剋扼要
_guang_guang_pi_chu_tuo_hei_me_niao	逛逛辟除脱黑么鸟
_kuang_kuang_mi_shu_nuo_zhei_de_liao	框框秘书诺这得了
_huang_huang_di_ru_luo_shei_te_jiao	黄黄底乳络谁特教
_zhuang_zhuang_ti_zu_guo_zei_ne_qiao	壮壮题组国贼呢桥
_chuang_chuang_ni_cu_kuo_wei_le_xiao	闯闯你粗扩为了小
_shuang_shuang_li_su_huo_dui_ge_ou	双双李素或对各偶
_yong_yong_ji_yu_ka_mu_ji_nao	用用基于卡姆激恼
_dong_dong_qi_nv_ha_fu_qi_lao	东东妻女哈芙其老
_tong_tong_xi_lv_zha_du_xi_gao	统统希律扎渡西高
_nong_nong_wu_da_jie_mo_tui_shao	浓浓五嗲芥末退烧
_long_long_bu_ta_qie_fo_gui_rao	龙龙不塌且佛规绕
_gong_gong_pu_na_xie_duo_kui_zao	公共普纳写多亏早
_kong_kong_mu_la_yue_tuo_hui_cao	空空穆拉越拖会操
_hong_hong_fu_ga_nue_nuo_zhui_sao	红红腹噶虐诺追烧
_jiong_jiong_du_ka_lue_luo_chui_yao	炯炯读卡略落槌要
_qiong_qiong_tu_ha_jue_guo_shui_niao	琼琼吐哈觉果水鸟
_xiong_xiong_nu_zha_que_kuo_rui_liao	熊熊怒炸却阔蕊了
_zhong_zhong_lu_cha_xue_huo_zui_jiao	中中路查血或嘴角
_chong_chong_gu_sha_ei_dong_ya_ou	崇崇古沙欸东亚偶
_rong_rong_ku_za_bei_tong_dia_ben	蓉荣枯咋悲痛嗲本
_zong_zong_hu_ca_pei_nong_lia_pou	总总胡擦配弄俩剖
_cong_cong_zhu_sa_mei_long_jia_mou	匆匆著萨梅隆加缪
_song_song_chu_ya_fei_gong_qia_fou	松松出牙飞贡恰否
_yi_yi_wu_dia_dei_kong_xia_dou	依依五嗲得空暇都
_bi_bi_bu_lia_tei_hong_wa_tou	比比不俩忒红袜头
_pi_pi_pu_jia_nei_jiong_gua_nen	皮皮普加内囧挂嫩
_mi_mi_mu_qia_lei_qiong_kua_lou	秘密目恰雷穹跨楼
_di_di_fu_xia_gei_xiong_hua_gou	滴滴俯下给熊花狗
_ti_ti_du_wa_kei_zhong_zhua_kou	提提杜瓦剋中抓扣
_ni_ni_tu_gua_hei_chong_chua_hou	妮妮图挂黑冲欻后
_li_li_nu_kua_zhei_rong_shua_zhou	李丽奴跨这榕刷周
_ji_ji_lu_hua_shei_zong_wo_liao	集集鹿花谁总我聊
_qi_qi_gu_zhua_zei_cong_bo_jiao	七七谷抓贼从跛脚
_xi_xi_ku_chua_wei_song_po_qiao	喜喜库欻未送破桥
_wu_wu_yu_shi_sa_cong_mo_xiao	五五于是撒从磨削
_bu_bu_nv_ri_ya_song_fo_ou	步步女日押送佛偶
_pu_pu_lv_a_dui_yi_tui_lao	噗噗绿啊对一推老
_mu_mu_ju_ba_tui_bi_gui_gao	沐沐聚吧退避贵高
_fu_fu_qu_pa_gui_pi_kui_kao	夫妇去爬桂皮亏靠
_du_du_xu_ma_kui_mi_hui_hao	嘟嘟需马奎密会好
_tu_tu_er_ci_ga_ni_wei_zhao	兔兔二次尕妮韦昭
_nu_nu_zi_ri_dia_li_dui_chao	努努紫日嗲里对朝
_lu_lu_ci_a_hui_di_zhui_ao	露露次啊惠帝追奥
_gu_gu_si_ba_zhui_ti_chui_bao	姑姑四八椎体锤爆
_ku_ku_zhi_fa_chui_ni_shui_pao	苦苦执法吹你水泡
_hu_hu_chi_da_shui_li_rui_mao	呼呼吃大水里瑞毛
_zhu_zhu_shi_ta_rui_ji_zui_dao	猪猪是他瑞吉醉倒
_chu_chu_ri_na_zui_qi_cui_tao	处处日娜最气催讨
_shu_shu_a_re_sui_xi_sui_nao	叔叔啊热随喜随闹
_ru_ru_ba_ze_biao_mie_zuo_ben	如如巴泽表灭做本
_zu_zu_pa_ce_piao_die_cuo_pou	足足怕测票跌挫剖
_cu_cu_ma_se_miao_tie_suo_mou	粗粗马瑟秒铁索某
_su_su_fa_ye_e_kua_pu_dao	速速法爷额跨扑到
_yu_yu_er_si_ka_bu_yue_pou	郁郁而死卡不约剖
_nv_nv_zi_pa_cui_wu_qie_ou	女女子怕崔五且偶
_lv_lv_ci_ma_sui_bu_xie_ben	屡屡此马燧不写本
_ju_ju_si_fa_biao_se_hua_shao	句句司法标色花哨
_qu_qu_zhi_la_piao_ye_me_zao	去取汁拉票也么早
_xu_xu_chi_ga_miao_bie_de_cao	需需持噶秒别的操
_er_er_zi_da_diao_pie_te_sao	尔尔子打掉撇特骚
_zi_zi_zhi_ka_yi_a_mi_ao	字字纸卡以阿米奥
_ci_ci_chi_ha_bi_ba_di_bao	此次吃哈比八低保
_si_si_shi_zha_pi_pa_ti_pao	四四使诈琵琶踢泡
_zhi_zhi_a_bie_zhuo_jia_ji_mao	直至啊别卓佳鸡毛
_chi_chi_ba_pie_chuo_qia_qi_dao	吃吃吧别戳恰奇道
_shi_shi_pa_mie_shuo_xia_xi_tao	是是怕咩说下西逃
_ri_ri_ma_die_ruo_wa_wu_mao	日日马蝶若哇五毛
_er_a_hong_liu_gong_ei_sa_jiong	而啊洪流共欸撒囧
_er_xu_su_di_xie_ri_ci_dao	而需速递谢日刺刀
_er_e_ri_zi_er_qu_cu_zao	而额日子而去粗造
_er_ba_qiong_lao_ri_er_ju_mao	而把穷老日而橘猫
_er_yu_yi_wo_yu_wu_fei_a	而予以我与无非啊
_er_nv_bi_bo_nv_bu_dei_ba	儿女碧波女不得把
_er_lv_pi_po_lv_pu_tei_pa	而绿皮破吕普忒怕
_er_wo_mi_mo_ju_mu_nei_ma	而我秘魔剧目内码
_er_bo_di_fo_qu_fu_lei_fa	而博迪佛曲父类发
_er_po_ti_duo_xu_du_gei_da	而破题多虚度给大
_er_mo_ni_e_yu_tu_kei_ta	而模拟额玉兔剋他
_er_fo_li_me_nv_nu_hei_na	而佛理么女奴黑那
_er_duo_ji_de_lv_lu_zhei_la	耳朵记得吕禄这啦
_er_tuo_qi_te_ju_gu_shei_ga	尔托奇特距骨谁噶
_er_nuo_xi_ne_qu_ku_zei_ka	而诺西呢曲库贼卡
_er_zhu_yi_le_xu_hu_wei_ha	而注意了徐虎为哈
_er_chu_bi_niu_yu_zhu_dui_zha	而出比牛与主队炸
_er_shu_pi_liu_nv_chu_tui_cha	耳鼠皮瘤女出退差
_er_ru_mi_jiu_lv_shu_gui_sha	而入米酒绿树鬼煞
_er_ji_zuo_qiu_ju_ru_kui_za	而级左丘惧汝魁咋
_er_qi_cuo_xiu_qu_zu_hui_ca	而期错修去组会擦
_er_xi_suo_jiu_xu_mi_chang_rao	儿媳所救须弥长绕
_er_zu_jiao_zu_zun_jie_zhi_zong	而祖教祖尊戒指总
_er_cu_qiao_cu_cun_qie_chi_cong	而簇桥粗村切齿从
_er_su_xiao_su_sun_xie_shi_song	而速小苏孙协是送
_er_luo_er_wu_zhun_de_zhu_zhui	而落而五准的铸锥
_er_me_er_bu_chun_te_chu_chui	儿么而不纯特出吹
_er_ye_er_pu_shun_ne_shu_shui	而耶尔普顺呢熟睡
_er_you_er_mu_run_le_ru_rui	而又耳目润了如瑞
_er_di_zhuo_zhi_zhuo_zhu_zuan_za	而地卓志捉住钻咋
_er_ti_chuo_chi_chuo_chu_cuan_ca	而提戳吃戳出窜擦
_er_ni_shuo_shi_shuo_shu_suan_sa	而你说是说数算撒
_er_li_ruo_ri_ruo_ru_ruan_ya	而立若日若如软呀
_er_du_ran_ge_bu_fang_ruan_ma	而度染个不放软麻
_er_tu_duan_ke_pu_wang_zuan_fa	而图段克普王钻发
_er_nu_tuan_he_mu_guang_cuan_da	而怒团河目光窜大
_er_lu_nuan_zhe_fu_kuang_suan_ta	而路暖着富矿算他
_er_gu_luan_che_du_huang_wen_na	耳鼓乱扯毒皇温拿
_er_ku_gun_she_tu_zhuang_dun_la	而哭滚设涂装顿啦
_er_hu_kun_re_nu_chuang_tun_ga	而沪昆惹怒床屯嘎
_er_fu_hun_me_lu_shuang_lun_ka	而复混么路双轮卡
_er_yi_zhe_gu_wen_die_lun_ha	而已这个文叠论哈
_er_bi_che_ku_dun_tie_gun_zha	耳鼻车库蹲贴滚轧
_er_pi_she_hu_tun_nie_kun_cha	而皮射虎屯捏坤查
_er_mi_re_wu_lun_lie_hun_sha	而米热舞论列婚纱
_er_bie_ku_en_e_xi_tuo_ran	而别哭嗯额洗脱然
_er_pie_hu_ben_ze_zu_zong_jiu	而撇护本则祖宗就
_er_mie_zhu_pen_ce_cu_cong_qiu	而灭诸喷测粗从求
_er_die_chu_men_se_su_song_xiu	而叠出门色素送修
_er_tie_shu_feng_ran_nue_fang_bei	儿帖数峰然虐防备
_er_nie_ru_deng_duan_lue_wang_pei	而嗫嚅等段略王培
_er_lie_zu_teng_tuan_jue_zi_zong	而列祖腾团橛子总
_er_jie_cu_neng_nuan_que_ci_cong	而节粗能暖阙词从
_er_qie_su_leng_luan_xue_si_song	而且速冷乱学四送
_er_xie_yu_e_zi_ju_ge_dun	而写余额字句个盾
_er_yue_nv_me_ci_qu_ke_tun	而越女么辞去可吞
_er_nue_lv_de_si_xu_he_lun	而虐率的思绪赫伦
_er_lue_ju_te_zhi_ju_zhe_gun	而略具特之举这滚
_er_jue_qu_ne_chi_qu_che_kun	而绝去呢吃驱车困
_er_que_xu_le_shi_xu_she_hun	而却续了时序摄魂
_er_xue_gou_bu_cang_ben_bo_duan	耳穴够不藏本波段
_er_de_dou_pu_sang_pen_po_tuan	尔德都普桑喷破团
_er_te_tou_mu_yang_men_mo_nuan	尔特头目杨门莫暖
_er_ne_nou_fu_niang_fen_fo_luan	儿呢耨妇娘粉佛乱
_er_le_lou_du_liang_nen_duo_ruan	儿了楼度良嫩多软
_er_ge_gou_tu_geng_gen_tuo_zuan	儿哥狗图更根托钻
_er_ke_kou_nu_keng_ken_nuo_cuan	儿可口努坑肯诺窜
_er_he_hou_lu_heng_hen_luo_suan	儿和后路横狠落酸
_er_zhe_zou_gu_zheng_zhen_guo_wen	儿这走谷正真国文
_er_che_cou_ku_cheng_chen_kuo_dun	儿车凑库成陈阔顿
_er_she_sou_hu_sheng_shen_huo_tun	儿蛇搜虎声深火吞
_er_re_rou_zhu_reng_ren_zhuo_lun	儿热肉猪仍人拙伦
_er_ze_zou_chu_zeng_zen_chuo_gun	儿则走出增怎戳棍
_er_ce_cou_shu_ceng_cen_shuo_kun	儿策凑书层岑说困
_er_se_sou_ru_seng_sen_ruo_hun	儿色搜入僧森弱魂
_er_guo_jiong_gun_zuo_zi_yue_gua	儿国窘棍坐字月瓜
_er_kuo_qiong_kun_cuo_ci_nue_kua	儿扩穷困错词虐夸
_er_huo_xiong_hun_suo_si_lue_hua	儿火熊魂锁思掠华
_er_zhuo_zhong_zhun_diu_zi_jue_zhua	儿卓中准丢字决抓
_er_chuo_chong_chun_niu_ci_que_chua	儿戳虫春牛刺缺歘
_er_shuo_rong_shun_liu_si_xue_shua	儿说容顺流思雪刷
_er_zuo_zong_zun_jiu_zhi_jue_jia	儿做宗尊酒只决家
_er_cuo_cong_cun_qiu_chi_que_qia	儿错从存秋吃缺掐
_er_suo_song_sun_xiu_shi_xue_xia	儿锁松孙秀诗雪下
_zi_wo_wu_biao_yi_nuo_yong_mei	自我无表以诺用美
_zi_bo_bu_piao_bi_luo_dong_fei	自播步飘比落动飞
_zi_po_pu_miao_pi_guo_tong_dei	自坡普苗皮果通得
_zi_mo_mu_diao_mi_kuo_nong_tei	自墨木雕米阔农忒
_zi_fo_fu_tiao_di_huo_long_nei	自佛服条地火龙内
_zi_duo_du_you_ti_ge_gong_lei	自多度游提个工雷
_zi_tuo_tu_miu_ni_ke_kong_gei	自托图谬你可孔给
_zi_nuo_nu_diu_li_he_hong_kei	自诺努丢李合红剀
_zi_luo_lu_niu_ji_ze_jiong_hei	自落路牛几则窘黑
_zi_guo_gu_liu_qi_ce_qiong_zhei	自国古流气策穷这
_zi_kuo_ku_jiu_xi_se_xiong_shei	自扩库酒西色熊谁
_zi_huo_hu_qiu_wu_gong_deng_zei	自火胡秋无功登贼
_zi_zhuo_zu_xiu_wo_gong_teng_wei	自卓组秀我功腾为
_zi_chuo_cu_yong_yang_niang_liang_jiang	自戳簇拥阳娘两将
_zi_shuo_su_rong_qiang_xiang_eng_run	自说素容强相恩润
_er_pa_zhi_zuo_yi_ye_ken_biao	而怕之作一叶肯表
_er_ma_zhi_cuo_bi_bie_hen_piao	而马之错比别狠飘
_er_fa_zhi_suo_pi_pie_zhen_miao	而发之所披撇真妙
_er_dan_bei_yu_di_mie_chen_diao	而单被与地灭尘掉
_er_tan_pei_yu_ti_die_shen_tiao	而谭配与体跌神调
_er_nan_mei_yu_ni_tie_ren_you	而南美与泥铁人友
_er_lan_fei_yu_li_nie_zen_miu	而兰飞与李捏怎谬
_er_gan_dei_yu_ji_lie_cen_zei	而干得与极力岑贼
_er_kan_tei_yu_qi_jie_sen_wei	而看特与齐节森威
_er_han_nei_yu_xi_qie_zhun_dia	而寒内与细切准嗲
_er_zhan_lei_zhi_yu_yue_chun_lia	而战雷之与月春俩
_er_chan_gei_zhi_nv_nue_shun_jia	而禅给之女虐顺家
_er_shan_kei_zhi_lv_lue_run_qia	而山剋之绿略润掐
_er_zan_hei_zi_yu_jue_zun_xia	而赞黑子与决绝下
_er_can_zhei_zi_nv_que_cun_wa	而残这子女确存蛙
_er_san_shei_zi_lv_xue_sun_ei	而三谁子绿雪孙诶
_zhi_yi_fang_dui_zhi_ni_chuang_chui	之一方对之你窗吹
_zhi_bi_wang_tui_zhi_li_shuang_shui	之笔忘退之李双水
_zhi_pi_guang_gui_zhi_ji_yong_rui	之皮光贵之即用瑞
_zhi_mi_kuang_kui_zhi_qi_dong_zui	之米矿亏之起动罪
_zhi_di_huang_hui_zhi_xi_tong_cui	之地黄灰之西通脆
_zhi_ti_zhuang_zhui_zi_yi_nong_sui	之体状追子一浓随
_yu_wo_a_yu_re_a_e_za	与我啊与热啊额扎
_yu_bo_ba_yu_ze_ba_e_ca	与波吧与泽巴额擦
_yu_po_pa_yu_ce_pa_e_sa	与坡爬与策爬额撒
_yu_mo_ma_yu_se_ma_e_ya	与莫麻与色马额呀
_yu_fo_fa_yu_ye_fa_e_dia	与佛发与夜发额嗲
_yu_duo_da_yu_bie_da_e_lia	与多大与别大额俩
_yu_tuo_ta_yu_pie_ta_e_jia	与托塔与撇塔额加
_yu_nuo_na_yu_mie_na_e_qia	与诺那与灭那额掐
_yu_luo_zhun_yu_die_la_e_xia	与罗准与蝶拉额夏
_yu_guo_chun_yu_tie_ga_e_niu	与过春与铁嘎额牛
_yu_kuo_shun_yu_nie_ka_e_liu	与阔顺与捏卡额流
_yu_huo_run_yu_lie_ha_e_jiu	与火润与列哈额酒
_yu_zhuo_zun_yu_jie_zha_e_qiu	与卓尊与结扎额秋
_yu_chuo_cun_yu_qie_cha_e_xiu	与戳存与切查额秀
_yu_shuo_sun_yu_xie_sha_e_zhong	与说孙与写沙额中
_yu_ruo_fang_zi_bi_long_e_chong	与若房子比龙额虫
_yu_zuo_wang_zi_pi_gong_e_rong	与左王子皮功额容
_yu_cuo_guang_zi_mi_kong_e_zong	与错光子密空额总
_yu_suo_kuang_zi_di_hong_e_cong	与索框子地红额从
_zi_ruo_huang_zi_ti_jiong_e_song	自若皇子体窘额送
_zi_zuo_zhuang_zi_ni_qiong_yi_zong	自左庄子你穷以总
_zi_cuo_chuang_zi_li_xiong_yi_cong	自错窗子里汹以从
_zi_suo_shuang_zi_ji_zhong_yi_song	自索双子几中以送
_er_ruo_kong_zi_qi_chong_er_ya	而若空子起虫而压
_zhi_fo_hong_zi_xi_rong_er_dia	之佛红子西容而调
_zhi_ye_a_zi_e_zhun_zhi_duo	之叶啊子额准之多
_zhi_bie_ba_zi_me_chun_zhi_tuo	之别巴子么春之拖
_zhi_pie_pa_zi_de_shun_zhi_nuo	之撇爬子得顺之诺
_zhi_mie_ma_zi_te_run_zhi_luo	之灭马子特润之落
_zhi_die_fa_zi_ne_zun_zhi_guo	之叠发子呢尊之国
_zhi_tie_da_zi_le_cun_zhi_kuo	之铁大子了存之阔
_zhi_nie_ta_zi_ge_sun_zhi_huo	之捏塔子格孙之火
_zhi_lie_na_zi_ke_fang_zhi_e	之列那子可放之额
_zhi_jie_la_zi_he_wang_zhi_me	之结拉子合王之么
_zhi_qie_ga_zi_zhe_guang_zhi_de	之切嘎子着光之得
_zhi_xie_ka_zi_che_kuang_zhi_te	之写卡子车框之特
_zhi_yue_ha_zi_she_huang_zhi_ne	之月哈子舍黄之呢
_zhi_nue_zha_zi_re_zhuang_zhi_le	之虐炸子热装之了
_zhi_lue_cha_zi_ze_chuang_zhi_ge	之掠查子则窗之格
_zhi_zhe_dong_zi_ce_shuang_zhi_ke	之这动子侧双之可
_zhi_che_tong_zi_se_yong_zhi_he	之车童子色用之和
_zhi_she_nong_zi_ye_sha_zhi_ze	之设农子叶沙之则
_zhi_re_long_zi_bie_za_zhi_ce	之热龙子别扎之策
_er_duan_gua_zi_pie_ca_zhi_se	而断瓜子撇擦之色
_er_tuan_kua_zi_mie_sa_zi_lia	而团夸子灭撒子俩
_er_nuan_hua_zi_jie_zong_zi_jia	而暖华子结总子家
_er_luan_zhua_zi_qie_cong_zi_qia	而乱爪子切从子掐
_er_ruan_chua_zi_xie_song_zi_xia	而软欻子写松子下
_er_zuan_shua_zi_die_ya_zi_wa	而钻刷子叠压子哇
_er_cuan_wo_zi_tie_dia_zi_gua	而窜我子铁调子瓜
_er_suan_ye_zi_nie_lia_zi_kua	而酸叶子捏俩子夸
_er_wen_bie_zi_lie_wa_zi_hua	而文别子裂哇子花
_er_dun_pie_er_lao_xia_zi_zhua	而顿撇而老下子抓
_er_tun_mie_er_gao_wa_zi_chua	而吞灭而高哇子刷
_er_lun_yue_er_kao_gua_zi_shua	而轮月而考瓜子刷
_er_ou_a_er_hao_kua_zi_wu	而欧啊而好夸子无
_er_pou_ba_er_zhao_hua_zi_bu	而剖巴而照华子布
_er_mou_pa_er_chao_zhua_zi_pu	而谋爬而超爪子铺
_er_fou_ma_er_shao_chua_zi_mu	而否马而少欻子木
_er_dou_fa_er_rao_shua_zi_fu	而豆发而饶刷子夫
_er_tou_da_er_zao_bo_zi_du	而头大而早波子度
_er_lou_ta_er_cao_po_zi_tu	而楼塔而草破子图
_er_gou_na_er_sao_mo_zi_nu	而狗那而骚墨子奴
_er_kou_la_er_yao_fo_zi_lu	而口拉而要佛子路
_er_hou_ga_er_niao_duo_zi_gu	而候嘎而尿多子古
_er_zhou_ka_er_liao_tuo_zi_ku	而周卡而辽驼子库
_er_chou_ha_er_jiao_nuo_zi_hu	而丑哈而教诺子胡
_er_shou_zha_er_qiao_luo_zi_zhu	而手扎而桥落子竹
_er_rou_cha_er_xiao_guo_zi_chu	而柔茶而小果子处
_er_zou_sha_er_biao_kuo_zi_shu	而走沙而标阔子书
_er_cou_za_er_piao_huo_zi_ru	而凑扎而飘火子入
_er_sou_ca_er_miao_zhuo_zi_zu	而搜擦而妙卓子族
_er_bao_sa_er_diao_chuo_zi_cu	而包撒而调戳子粗
_er_pao_ya_er_tiao_shuo_zi_su	而抛呀而跳说子苏
_er_mao_dia_er_miu_ruo_er_jiu	而毛凋而谬若而酒
_er_dao_lia_er_diu_zuo_er_qiu	而道俩而丢作而球
_er_tao_jia_er_niu_cuo_er_xiu	而桃家而牛错而秀
_er_nao_qia_er_liu_suo_er_ran	而脑恰而流索而燃
_zhi_wu_zui_zhi_lu_hong_zhi_shu	知物最知路红之树
_zhi_bu_cui_zhi_gu_jiong_zhi_ru	知不脆知古窘之入
_zhi_pu_sui_zhi_ku_qiong_zhi_zu	知朴素知库穷之族
_zhi_mu_dong_zhi_hu_xiong_zhi_cu	知木动知虎汹之粗
_zhi_fu_tong_zhi_zhu_zhong_zhi_su	知夫通知竹中之苏
_zhi_du_nong_zhi_chu_chong_er_neng	知度农知出虫而能
_zhi_tu_long_zhi_nu_kong_er_beng	知土龙知奴空而崩
_ye_guang_yi_qiu_er_lia_yi_ma	夜光一秋而俩一马
_ye_kuang_yi_xiu_er_jia_yi_fa	夜框一秀而加一发
_ye_huang_yi_ran_er_qia_yi_da	夜黄一燃而掐一大
_ye_zhuang_yi_duan_er_xia_yi_ta	夜庄一断而下一塔
_ye_chuang_yi_tuan_er_wa_yi_na	夜窗一团而外一那
_ye_shuang_yi_nuan_er_gua_yi_la	夜双一暖而瓜一拉
_ye_yong_yi_luan_er_kua_yi_ga	夜用一乱而夸一嘎
_ye_dong_yi_ruan_er_hua_yi_ka	夜动一软而华一卡
_ye_tong_yi_zuan_er_zhua_yi_ha	夜同一钻而抓一哈
_ye_nong_yi_cuan_er_chua_yi_zha	夜浓一窜而刷一扎
_ye_long_yi_suan_er_shua_yi_cha	夜龙一酸而刷一查
_ye_gong_yi_wen_yi_shun_yi_sha	夜工一文一顺一沙
_ye_kong_yi_dun_yi_run_yi_za	夜空一顿一润一扎
_ye_hong_yi_tun_yi_zun_yi_ca	夜红一吞一尊一擦
_ye_jiong_yi_lun_yi_cun_yi_sa	夜窘一轮一寸一撒
_ye_qiong_yi_gun_yi_sun_yi_ya	夜穷一滚一孙一呀
_ye_xiong_yi_kun_yi_biao_yi_dia	夜汹一困一表一嗲
_ye_zhong_yi_hun_yi_piao_yi_lia	夜中一浑一飘一俩
_ye_chong_yi_zhun_yi_miao_yi_jia	夜虫一准一妙一家
_ye_rong_yi_chun_yi_diao_yi_qia	夜容一春一调一掐
_er_gun_yi_hua_yi_tiao_yi_xia	而滚一花一调一下
_er_kun_yi_zhua_yi_you_yi_wa	而困一抓一游一瓦
_er_hun_yi_chua_yi_miu_yi_gua	而浑一窜一谬一瓜
_er_zhun_yi_shua_yi_diu_yi_kua	而准一刷一丢一夸
_er_wang_er_chun_yu_zong_er_cun	而王而春与宗而存
_er_zong_er_shun_yu_cong_er_sun	而宗而顺与丛而孙
_er_cong_er_run_yu_song_er_fang	而丛而润与松而芳
_er_ei_yu_ei_zi_ei_zhi_ei	而欸与欸子欸之欸
_er_bei_yu_bei_zi_bei_zhi_bei	而北与北子北之北
_er_pei_yu_pei_zi_pei_zhi_pei	而陪与陪子陪之陪
_er_mei_yu_mei_zi_mei_zhi_mei	而美与梅子美之美
_er_fei_yu_fei_zi_fei_zhi_fei	而飞与飞子飞之飞
_er_dei_yu_dei_zi_dei_zhi_dei	而得与得子得之得
_er_tei_yu_tei_zi_tei_zhi_tei	而忒与忒子忒之忒
_er_nei_yu_nei_zi_nei_zhi_nei	而内与内子内之内
_er_lei_yu_lei_zi_lei_zhi_lei	而雷与雷子雷之雷
_er_gei_yu_gei_zi_gei_zhi_gei	而给与给子给之给
_er_kei_yu_kei_zi_kei_zhi_kei	而剋与剋子剋之剋
_er_hei_yu_hei_zi_hei_zhi_hei	而黑与黑子黑之黑
_er_zhei_yu_zhei_zi_zhei_zhi_zhei	而这与这子这之这
_er_shei_yu_shei_zi_shei_zhi_shei	而谁与谁子谁之谁
_er_zei_yu_zei_zi_zei_zhi_zei	而贼与贼子贼之贼
_er_wei_yu_wei_zi_wei_zhi_wei	而为与为子为之为
_er_dui_yu_dui_zi_dui_zhi_dui	而对与对子对之对
_er_tui_yu_tui_zi_tui_zhi_tui	而退与退子退之退
_er_gui_yu_gui_zi_gui_zhi_gui	而归与归子归之归
_er_kui_yu_kui_zi_kui_zhi_kui	而亏与亏子亏之亏
_er_hui_yu_hui_zi_hui_zhi_hui	而会与会子会之会
_er_zhui_yu_zhui_zi_zhui_zhi_zhui	而追与追子追之追
_er_chui_yu_chui_zi_chui_zhi_chui	而吹与吹子吹之吹
_er_shui_yu_shui_zi_shui_zhi_shui	而水与水子水之水
_er_rui_yu_rui_zi_rui_zhi_rui	而瑞与瑞子瑞之瑞
_er_zui_yu_zui_zi_zui_zhi_zui	而醉与醉子醉之醉
_er_cui_yu_cui_zi_cui_zhi_cui	而翠与翠子翠之翠
_er_sui_yu_sui_zi_sui_zhi_sui	而碎与碎子碎之碎
_er_guang_yu_guang_zi_guang_zhi_guang	而光与光子光之光
_er_kuang_yu_kuang_zi_kuang_zhi_kuang	而框与框子框之框
_er_huang_yu_huang_zi_huang_zhi_huang	而黄与黄子黄之黄
_er_zhuang_yu_zhuang_zi_zhuang_zhi_zhuang	而装与装子装之装
_er_chuang_yu_chuang_zi_chuang_zhi_chuang	而窗与窗子窗之窗
_er_shuang_yu_shuang_zi_shuang_zhi_shuang	而双与双子双之双
_er_yong_yu_yong_zi_yong_zhi_yong	而用与用子用之用
_er_dong_yu_dong_zi_dong_zhi_dong	儿动于动子动之动
_er_tong_yu_tong_zi_tong_zhi_tong	儿同于同子同之同
_er_nong_yu_nong_zi_nong_zhi_nong	儿农于农子农之农
_er_long_yu_long_zi_long_zhi_long	儿龙于龙子龙之龙
_er_gong_yu_gong_zi_gong_zhi_gong	儿工于工子工之工
_er_kong_yu_kong_zi_kong_zhi_kong	儿空于空子空之空
_er_hong_yu_hong_zi_hong_zhi_hong	儿红于红子红之红
_er_jiong_yu_jiong_zi_jiong_zhi_jiong	儿窘于窘子窘之窘
_er_qiong_yu_qiong_zi_qiong_zhi_qiong	儿穷于穷子穷之穷
_er_xiong_yu_xiong_zi_xiong_zhi_xiong	儿熊于熊子熊之熊
_er_zhong_yu_zhong_zi_zhong_zhi_zhong	儿中于中子中之中
_er_chong_yu_chong_zi_chong_zhi_chong	儿虫于虫子虫之虫
_er_rong_yu_rong_zi_rong_zhi_rong	儿容于容子容之容
_yu_zhun_yu_biao_zi_biao_zhi_biao	于准于标子标之标
_yu_chun_yu_piao_zi_piao_zhi_piao	于春于飘子飘之飘
_yu_shun_yu_miao_zi_miao_zhi_miao	于顺于苗子苗之苗
_yu_run_yu_diao_zi_diao_zhi_diao	于润于凋子凋之凋
_yu_zun_yu_tiao_zi_tiao_zhi_tiao	于尊于挑子挑之挑
_yu_cun_yu_you_zi_you_zhi_you	于存于有子有之有
_yu_sun_yu_miu_zi_miu_zhi_miu	于孙于谬子谬之谬
_yu_fang_yu_diu_zi_diu_zhi_diu	于方于丢子丢之丢
_yu_wang_yu_niu_zi_niu_zhi_niu	于王于牛子牛之牛
_zi_zhun_yu_liu_zi_liu_zhi_liu	子准于流子流之流
_zi_chun_yu_jiu_zi_jiu_zhi_jiu	子春于酒子酒之酒
_zi_shun_yu_qiu_zi_qiu_zhi_qiu	子顺于球子球之球
_zi_run_yu_xiu_zi_xiu_zhi_xiu	子润于秀子秀之秀
_zi_zun_yu_ran_zi_ran_zhi_ran	子尊于然子然之然
_zi_cun_yu_duan_zi_duan_zhi_duan	子存于段子段之段
_zi_sun_yu_tuan_zi_tuan_zhi_tuan	子孙于团子团之团
_zi_fang_yu_nuan_zi_nuan_zhi_nuan	子方于暖子暖之暖
_zi_wang_yu_luan_zi_luan_zhi_luan	子王于乱子乱之乱
_zhi_zhun_yu_ruan_zi_ruan_zhi_ruan	之准于软子软之软
_zhi_chun_yu_zuan_zi_zuan_zhi_zuan	之春于钻子钻之钻
_zhi_shun_yu_cuan_zi_cuan_zhi_cuan	之顺于窜子窜之窜
_zhi_run_yu_suan_zi_suan_zhi_suan	之润于酸子酸之酸
_zhi_zun_yu_wen_zi_wen_zhi_wen	之尊于文子文之文
_zhi_cun_yu_dun_zi_dun_zhi_dun	之存于顿子顿之顿
_zhi_sun_yu_tun_zi_tun_zhi_tun	之孙于吞子吞之吞
_zhi_fang_yu_lun_zi_lun_zhi_lun	之方于轮子轮之轮
_zhi_wang_yu_gun_zi_gun_zhi_gun	之王于棍子棍之棍
_er_song_yu_kun_zi_kun_zhi_kun	儿松于坤子坤之坤
_er_zun_yu_hun_zi_hun_zhi_hun	儿尊于浑子浑之浑
_yi_shao_yu_shao_zi_shao_zhi_shao	一少于少子少之少
_yi_rao_yu_rao_zi_rao_zhi_rao	一饶于饶子饶之饶
_yi_zao_yu_zao_zi_zao_zhi_zao	一早于早子早之早
_yi_cao_yu_cao_zi_cao_zhi_cao	一草于草子草之草
_yi_sao_yu_sao_zi_sao_zhi_sao	一骚于骚子骚之骚
_yi_yao_yu_yao_zi_yao_zhi_yao	一要于要子要之要
_yi_niao_yu_niao_zi_niao_zhi_niao	一鸟于鸟子鸟之鸟
_yi_liao_yu_liao_zi_liao_zhi_liao	一料于料子料之料
_yi_jiao_yu_jiao_zi_jiao_zhi_jiao	一教于教子教之教
_yi_qiao_yu_qiao_zi_qiao_zhi_qiao	一桥于桥子桥之桥
_yi_xiao_yu_xiao_zi_xiao_zhi_xiao	一小于小子小之小
_yi_ou_yu_ou_zi_ou_zhi_ou	一欧于欧子欧之欧
_yi_beng_yu_beng_zi_beng_zhi_beng	一蹦于蹦子蹦之蹦
_yi_pou_yu_pou_zi_pou_zhi_pou	一剖于剖子剖之剖
_yi_mou_yu_mou_zi_mou_zhi_mou	一某于某子某之某
_yi_fou_yu_fou_zi_fou_zhi_fou	一否于否子否之否
_yi_dou_yu_dou_zi_dou_zhi_dou	一豆于豆子豆之豆
_yi_tou_yu_tou_zi_tou_zhi_tou	一头于头子头之头
_yi_neng_yu_neng_zi_neng_zhi_neng	一能于能子能之能
_yi_lou_yu_lou_zi_lou_zhi_lou	一楼于楼子楼之楼
_yi_gou_yu_gou_zi_gou_zhi_gou	一狗于狗子狗之狗
_yi_kou_yu_kou_zi_kou_zhi_kou	一口于口子口之口
_yi_hou_yu_hou_zi_hou_zhi_hou	一候于候子候之候
_yi_zhou_yu_zhou_zi_zhou_zhi_zhou	一周于周子周之周
_yi_chou_yu_chou_zi_chou_zhi_chou	一抽于抽子抽之抽
_yi_shou_yu_shou_zi_shou_zhi_shou	一收于收子收之收
_yi_rou_yu_rou_zi_rou_zhi_rou	一肉于肉子肉之肉
_yi_zou_yu_zou_zi_zou_zhi_zou	一走于走子走之走
_yi_cou_yu_cou_zi_cou_zhi_cou	一凑于凑子凑之凑
_yi_sou_yu_sou_zi_sou_zhi_sou	一搜于搜子搜之搜
_yu_dao_yu_tao_zi_tao_zhi_tao	于道于桃子桃之桃
_yu_zhao_yu_nao_zi_nao_zhi_nao	于照于脑子脑之脑
_yu_chao_yu_lao_zi_lao_zhi_lao	于超于老子老之老
_zi_zhao_yu_gao_zi_gao_zhi_gao	子照于高子高之高
_zi_chao_yu_kao_zi_kao_zhi_kao	子超于考子考之考
_zhi_zhao_yu_hao_zi_hao_zhi_hao	之照于好子好之好
_zhi_chao_zhi_dang_lou_R_zhi_R	纸钞只当楼R之R
_a_R_wo_R_e_R_ye_R	啊R喔R额R耶R
_ei_R_en_R_eng_R_yi_R	欸R恩R鞥R一R
_u_R_yu_R_er_R_zi_R	乌R与R而R子R