_ba_pa_ma_fa_da_ta_na_la	爸趴妈发打他那拉
_ga_ka_ha_a_jia_qia_xia_e	嘎咖哈啊家洽虾额
_zha_cha_sha_ya_za_ca_sa_wu	炸查沙哑砸擦萨乌
_duan_tuan_nuan_luan_pan_man_fan_ei	端团暖乱判蛮烦欸
_guan_kuan_huan_wan_an_ran_ang_ei	官款换晚安然昂欸
_zhuan_chuan_shuan_ruan_zuan_cuan_suan_e	转船涮软钻窜算额
_bai_pai_mai_ai_tai_nai_lai_ao	摆拍迈埃太奶莱奥
_gai_kai_hai_wai_chai_shai_ei_e	改开海外拆晒欸额
_zai_cai_sai_rao_a_rang_a_ei	再猜赛绕啊让啊欸
_bo_po_mo_fo_wu_e_wu_a	波泼墨佛无恶呜啊
_duo_tuo_nuo_luo_guo_kuo_huo_e	多托诺罗国阔霍额
_zhuo_chuo_shuo_ruo_zuo_cuo_suo_a	卓戳说若做错索啊
_de_te_ne_le_ge_ke_he_e	得特讷勒哥渴和饿
_zhe_che_she_re_ze_ce_se_a	这车设热则测色啊
_bu_pu_mu_fu_du_tu_nu_lu	不铺幕府赌徒奴鲁
_zhu_chu_shu_ru_gu_ku_hu_ou	住处输入孤苦互殴
_bei_pei_mei_fei_dei_tei_nei_lei	被培梅菲嘚忒内类
_gei_kei_hei_zei_yun_a_zhei_shei	给剋黑贼晕啊这谁
_gui_kui_hui_wei_dui_tui_yin_ou	归愧悔卫队退隐偶
_zhui_chui_shui_rui_zui_cui_sui_ei	追吹水瑞最脆随欸
_bie_pie_mie_ye_die_tie_nie_lie	别撇灭野爹铁涅列
_jie_qie_xie_ei_jian_qian_xian_wu	截切写欸捡钱仙五
_yue_ao_jue_a_que_en_xue_e	粤澳绝啊却恩雪儿
_nue_yu_ei_ou_lue_wu_ei_ao	虐鱼欸偶略无欸奥
_dian_tian_nian_lian_bian_pian_mian_ei	点天年连边片面欸
_yuan_e_juan_ou_quan_ai_xuan_ao	员额卷偶全爱玄奥
_diao_tiao_niao_liao_biao_piao_miao_en	掉条尿疗表飘渺恩
_gao_kao_hao_yao_jiao_qiao_xiao_e	高考好要娇俏小额
_zhao_chao_shao_rao_zao_cao_sao_wu	照抄少扰早操扫五
_bang_pang_mang_fang_dang_tang_nang_lang	帮旁忙放荡堂囊浪
_guang_kuang_huang_qiang_xiang_ou_e_ei	光狂黄强想呕额欸
_zhuang_chuang_shuang_wang_rang_cang_sang_e	装床双网让沧桑额
_diu_tou_niu_liu_kou_hou_ao_ei	丢头牛柳口后奥欸
_zhou_chou_shou_rou_cou_sou_ou_a	粥稠瘦肉凑搜偶啊
_jiu_qiu_xiu_you_miu_fou_wo_ou	九球绣有缪否我偶
_dun_tun_nen_lun_pen_men_fen_e	顿屯嫩论喷门份额
_zhun_chun_shun_run_zun_cun_sun_en	准纯顺润尊村孙恩
_gun_kun_hun_wen_zu_cu_su_wu	滚坤混问祖粗俗五
_beng_peng_meng_feng_deng_teng_neng_leng	泵棚梦风登腾能冷
_zeng_ceng_seng_reng_geng_keng_heng_wu	增层僧仍更坑横屋
_dong_tong_nong_long_gong_kong_hong_ai	东通弄龙工控红爱
_zhong_chong_yong_rong_zong_cong_song_e	中冲雍容总从送额
_jiong_qiong_xiong_sheng_zheng_cheng_eng_e	囧穷凶生征程鞥额
_di_ti_ni_li_bi_pi_mi_e	地替你利弊披靡额
_ji_qi_xi_yin_qin_xin_ao_ang	机器吸引亲信奥昂
_bin_pin_min_nin_lin_ying_ming_e	斌贫民您林英名额
_ding_ting_ning_ling_qing_xing_ai_ou	丁听宁陵清醒艾欧
_bing_ping_fang_yin_fan_yi_fo_ei	并平方因翻译佛欸
_yi_sheng_yi_chen_yin_tian_yin_ei	医生依晨阴天音欸
_ju_qu_xun_yu_nv_lv_yun_e	据去训育女绿云额
_yu_pan_yu_mian_yu_ting_yu_fo	玉盘玉面欲停于佛
_yu_yi_yu_chuo_yu_sheng_yuan_fo	寓意于辍余生愿佛
_jun_qun_xun_yin_yun_pang_yun_ou	菌群巡音云旁云偶
_yun_mai_yun_fen_yun_tao_yun_ke	云麦云芬云涛云客
_yun_ne_yun_lu_yun_chi_yun_shi	韵讷韵路韵迟韵诗
_yun_hong_yun_rou_yun_ci_yun_si	云红云柔云慈云寺
_yan_kan_qian_han_xian_re_eng_ei	眼看前含显热鞥欸
_yi_ke_qi_he_xi_re_yi_wu	一刻起和吸热义务
_ai_xie_kei_qie_hei_xie_rou_ei	爱写剋且黑蟹肉欸
_yin_ken_qin_hen_xin_ruo_yin_wu	因恳亲狠心若因无
_ying_keng_qing_heng_xing_ru_ying_wu	应坑轻哼形如鹦鹉
_dia_yu_ku_qu_hu_xu_ru_ao	嗲欲哭去胡须如澳
_you_po_qie_fo_xiao_fei_ai_e	油泼且佛消费挨饿
_ong_pian_cong_mian_song_fen_a_ao	ong片从面送分啊奥
_me_pian_che_mian_she_feng_ai_fo	么片扯面蛇蜂艾佛
_ye_er_pian_er_mi_er_fan_er	耶尔片儿米尔反而
_wo_er_shi_er_rong_er_ci_er	我儿时而从而刺耳
_er_ting_er_niu_er_ken_er_a	而听而纽尔肯儿啊
_er_qu_er_xiang_er_lia_er_ou	而去而香儿俩而偶
_er_sai_er_yin_er_wu_er_er	耳塞耳音而无尔尔
_er_yun_er_heng_er_ei_er_chi	而运而恒而欸而迟
_chi_e_er_ao_er_e_ang_ao	吃额而奥而恶昂奥
_zhi_chi_shi_ri_ci_ci_si_chi	支持十日次次四尺
_ci_shi_si_ri_yi_ci_yi_si	此时四日一次意思
_ci_pie_ci_min_ci_ting_ci_ke	此撇慈悯此亭此刻
_si_nie_si_lin_si_qing_si_e	斯涅斯林斯情斯和
_shi_feng_shi_xu_si_xu_ci_fo	诗风诗叙思绪此佛
_chi_pie_chi_min_chi_ting_chi_ke	吃撇吃民赤亭齿科
_shi_nie_shi_lin_shi_qing_shi_he	是聂世林诗情适合
_chi_a_eng_ao_zi_ai_qi_ao	吃啊鞥奥自爱齐奥
_chi_ei_ci_ei_yu_wu_ci_ao	吃欸此欸雨雾次奥
_yin_an_en_ei_yu_a_yi_ei	阴暗恩欸与阿姨欸
_ying_yi_ai_ying_ei_ci_en_ao	应以爱婴欸慈恩奥
_yu_e_yun_ei_yun_ao_yun_wu	余额云欸云傲云雾
_yu_ou_ong_ei_ying_ou_ong_ou	与偶ong欸应偶ong偶
_ci_hong_wo_ao_yin_e_chi_en	此红我凹印额吃嗯
_ying_ao_yi_ou_ong_ao_yu_ao	迎奥伊欧ong奥渝澳
_chi_ao_chi_wu_ci_wu	持奥池舞此物
